1111111111100110111010011100011100100000000000000
0000000000100000000000000000000000100000000000000
0000000000100000000000000000000000000000000000000
0000000000100000000000000000000000000000000000000
0000000000100000000000000000000000100000000000000
0000000000100000000000000000000000100000000000000
0000000000100000000000000000000000100000000000000
0000000000111111111000000000000000000000000000000
0000000000000000000000000000000000000000000000000
0000000000000000000000000000000000000000000000000
0000000000000000000000000000000000000000000000000
0000000000000000000000000000000000100000000000000
0000000000000000000000000000000000100000000000000
0000000000000000000000000000000000100000000000000
0000000000000000000000000000000000100000000000000
0000000000000000000000000000000000100000000000000
0000000000000000000000000000000000000000000000000
0000000000000000000000000000000000000000000000000
0000000000000000000011111111111111100000000000000
0000000000000000000000000000000000000000000000000
